%%%%%%%
% MD M%
%     %
S M  ME
%     %
% MD M%
%%%%%%%
