%%%%%%%%%%%%
%          %
% M  M     %
%          %
%          %
S M  M     %
%          %
%          %
%%E%%%%%%%%%
