%%%%%%%%
%MDM   %
%M M   %
S      E
%%%%%%%%
