%%%%%%%%
%M M   %
%M M   %
S      E
%%%%%%%%
