%%%%%%%%%%%%
% M     M  %
%          %
% M     D  E
%          %
S       M  %
%%%%%%%%%%%%
