%%%%%%%%%%%%
% M     M  %
%          %
% M   D    E
% D        %
S       M  %
%%%%%%%%%%%%
